00000000000000000000000000000000000000000000000000000000000000
00000000000000000000000000000000000000000000000000000000000000
00000000000000000000000000000000000000000000000000000000000000
00000000000000000000000000000000000000000000000000000000000000
22800000000000000000000000000000000000000000000000000000000000
11600000000000000000000000000000000000000000000000000000000000
11600000000000000000000000000000000000000000000000000000000000
11600000000007222228000000000000000000000000000000000000000000
11600000000005111116000000000000000000000000000000000000000000
11422222222223111114222222222222800000000000000000000000000000
11111111111111111111111111111111600000000000000000000000000000
11111111111111111111111111111111600000000000000000000000000000
11111111111111111111111111111111422222222222222222222222222222
11111111111111111111111111111111111111111111111111111111111111
11111111111111111111111111111111111111111111111111111111111111
11111111111111111111111111111111111111111111111111111111111111